# PART 3: O-Z (Alphabetical Division)
# Building lifecycle cost qualities from "Outdoor Foundation Utilities" through end of list
Outdoor Foundations and Slabs                                                                        = "semio.costs.global-life-cycle.life-cycle.investment-construction-phase.outdoor-facilities-and-open-spaces.foundation-substructure.foundations-and-slabs"
Outdoor Gas and Liquid Systems                                                                       = "semio.costs.global-life-cycle.life-cycle.investment-construction-phase.outdoor-facilities-and-open-spaces.technical-systems.gas-and-liquid"
Outdoor Heating Supply Systems                                                                       = "semio.costs.global-life-cycle.life-cycle.investment-construction-phase.outdoor-facilities-and-open-spaces.technical-systems.heating-supply"
Outdoor Roofs                                                                                        = "semio.costs.global-life-cycle.life-cycle.investment-construction-phase.outdoor-facilities-and-open-spaces.structural-components.roofs"
Outdoor Room Air Technology Systems                                                                  = "semio.costs.global-life-cycle.life-cycle.investment-construction-phase.outdoor-facilities-and-open-spaces.technical-systems.room-air-technology"
Outdoor Seals and Linings                                                                            = "semio.costs.global-life-cycle.life-cycle.investment-construction-phase.outdoor-facilities-and-open-spaces.foundation-substructure.seals-and-linings"
Outdoor Soil Improvement                                                                             = "semio.costs.global-life-cycle.life-cycle.investment-construction-phase.outdoor-facilities-and-open-spaces.foundation-substructure.soil-improvement"
Outdoor Structural Components                                                                        = "semio.costs.global-life-cycle.life-cycle.investment-construction-phase.outdoor-facilities-and-open-spaces.structural-components"
Outdoor Technical Systems                                                                            = "semio.costs.global-life-cycle.life-cycle.investment-construction-phase.outdoor-facilities-and-open-spaces.technical-systems"
Outdoor Usage Specific Systems                                                                       = "semio.costs.global-life-cycle.life-cycle.investment-construction-phase.outdoor-facilities-and-open-spaces.technical-systems.usage-specific"
Outdoor Wastewater Systems                                                                           = "semio.costs.global-life-cycle.life-cycle.investment-construction-phase.outdoor-facilities-and-open-spaces.technical-systems.wastewater"
Outdoor Water Systems                                                                                = "semio.costs.global-life-cycle.life-cycle.investment-construction-phase.outdoor-facilities-and-open-spaces.technical-systems.water"
Parking Spaces                                                                                       = "semio.costs.global-life-cycle.life-cycle.investment-construction-phase.outdoor-facilities-and-open-spaces.pavement-surface-courses.parking-spaces"
Partial Air Conditioning Systems                                                                     = "semio.costs.global-life-cycle.life-cycle.investment-construction-phase.technical-systems.room-air-technology.partial-air-conditioning"
Paths                                                                                                = "semio.costs.global-life-cycle.life-cycle.investment-construction-phase.outdoor-facilities-and-open-spaces.pavement-surface-courses.paths"
Pavement Surface Courses                                                                             = "semio.costs.global-life-cycle.life-cycle.investment-construction-phase.outdoor-facilities-and-open-spaces.pavement-surface-courses"
Permit Fees                                                                                          = "semio.costs.global-life-cycle.life-cycle.investment-construction-phase.land.acquisition.ancillary.permit-fees"
Planning Competitions                                                                                = "semio.costs.global-life-cycle.life-cycle.investment-construction-phase.construction-ancillary.preparation-of-object-planning.competitions"
Playground Areas                                                                                     = "semio.costs.global-life-cycle.life-cycle.investment-construction-phase.outdoor-facilities-and-open-spaces.pavement-surface-courses.playground-areas"
Power Supply                                                                                         = "semio.costs.global-life-cycle.life-cycle.investment-construction-phase.development.preparatory-measures.public-infrastructure-development.power-supply"
Prefabricated Ceiling Structures                                                                     = "semio.costs.global-life-cycle.life-cycle.investment-construction-phase.building-structural-components.ceilings-horizontal-structural-components.prefabricated-ceiling-structures"
Prefabricated External Wall Structures                                                               = "semio.costs.global-life-cycle.life-cycle.investment-construction-phase.building-structural-components.external-walls-vertical-structural-components-outside.prefabricated-external-wall-structures"
Prefabricated Internal Wall Structures                                                               = "semio.costs.global-life-cycle.life-cycle.investment-construction-phase.building-structural-components.internal-walls-vertical-structural-components-inside.prefabricated-internal-wall-structures"
Prefabricated Roof Structures                                                                        = "semio.costs.global-life-cycle.life-cycle.investment-construction-phase.building-structural-components.roofs.prefabricated-roof-structures"
Preparation of Object Planning                                                                       = "semio.costs.global-life-cycle.life-cycle.investment-construction-phase.construction-ancillary.preparation-of-object-planning"
Preparatory Measures                                                                                 = "semio.costs.global-life-cycle.life-cycle.investment-construction-phase.development.preparatory-measures"
Private Infrastructure Development                                                                   = "semio.costs.global-life-cycle.life-cycle.investment-construction-phase.development.preparatory-measures.private-infrastructure-development"
Process Heat Cold and Air Systems                                                                    = "semio.costs.global-life-cycle.life-cycle.investment-construction-phase.technical-systems.usage-specific-and-process-engineering.process-heat-cold-and-air"
Project Control                                                                                      = "semio.costs.global-life-cycle.life-cycle.investment-construction-phase.construction-ancillary.client-tasks.project-control"
Project Management                                                                                   = "semio.costs.global-life-cycle.life-cycle.investment-construction-phase.construction-ancillary.client-tasks.project-management"
Property Management                                                                                  = "semio.costs.global-life-cycle.life-cycle.operating-ongoing-use.operational-management.property-management"
Protective Installations                                                                             = "semio.costs.global-life-cycle.life-cycle.investment-construction-phase.building-structural-components.structural-installations.protective-installations"
Protective Structures                                                                                = "semio.costs.global-life-cycle.life-cycle.investment-construction-phase.outdoor-facilities-and-open-spaces.structural-components.protective-structures"
Public Infrastructure Development                                                                    = "semio.costs.global-life-cycle.life-cycle.investment-construction-phase.development.preparatory-measures.public-infrastructure-development"
Rail Traffic Facilities                                                                              = "semio.costs.global-life-cycle.life-cycle.investment-construction-phase.building-structural-components.infrastructure-facilities.rail-traffic-facilities"
Ramps Stairs Stands                                                                                  = "semio.costs.global-life-cycle.life-cycle.investment-construction-phase.outdoor-facilities-and-open-spaces.structural-components.ramps-stairs-stands"
Refrigeration Systems                                                                                = "semio.costs.global-life-cycle.life-cycle.investment-construction-phase.technical-systems.room-air-technology.refrigeration"
Regular Maintenance                                                                                  = "semio.costs.global-life-cycle.life-cycle.maintenance-and-modernization.regular-maintenance"
Renaturation or Reuse of Land                                                                        = "semio.costs.global-life-cycle.life-cycle.dismantling-and-disposal.renaturation-or-reuse-of-the-land"
Renovations for Technical Systems                                                                    = "semio.costs.global-life-cycle.life-cycle.investment-construction-phase.technical-systems.other-measures.renovations"
Replacement of Components                                                                            = "semio.costs.global-life-cycle.life-cycle.maintenance-and-modernization.replacement-of-components"
Road Traffic Facilities                                                                              = "semio.costs.global-life-cycle.life-cycle.investment-construction-phase.building-structural-components.infrastructure-facilities.road-traffic-facilities"
Roads                                                                                                = "semio.costs.global-life-cycle.life-cycle.investment-construction-phase.outdoor-facilities-and-open-spaces.pavement-surface-courses.roads"
Roof Claddings                                                                                       = "semio.costs.global-life-cycle.life-cycle.investment-construction-phase.building-structural-components.roofs.roof-claddings"
Roof Coverings                                                                                       = "semio.costs.global-life-cycle.life-cycle.investment-construction-phase.building-structural-components.roofs.roof-coverings"
Roof Openings                                                                                        = "semio.costs.global-life-cycle.life-cycle.investment-construction-phase.building-structural-components.roofs.roof-openings"
Roof Structures                                                                                      = "semio.costs.global-life-cycle.life-cycle.investment-construction-phase.building-structural-components.roofs.roof-structures"
Roofs                                                                                                = "semio.costs.global-life-cycle.life-cycle.investment-construction-phase.building-structural-components.roofs"
Roofs Replacement                                                                                    = "semio.costs.global-life-cycle.life-cycle.maintenance-and-modernization.replacement-of-components.roofs"
Room Air Technology Systems                                                                          = "semio.costs.global-life-cycle.life-cycle.investment-construction-phase.technical-systems.room-air-technology"
Room Heating Surfaces                                                                                = "semio.costs.global-life-cycle.life-cycle.investment-construction-phase.technical-systems.heating-supply.room-heating-surfaces"
Safety and Health Protection Coordination                                                            = "semio.costs.global-life-cycle.life-cycle.investment-construction-phase.construction-ancillary.client-tasks.safety-and-health-protection-coordination"
Safety Measures                                                                                      = "semio.costs.global-life-cycle.life-cycle.investment-construction-phase.development.preparatory-measures.site-preparation.safety-measures"
Safety Measures for Technical Systems                                                                = "semio.costs.global-life-cycle.life-cycle.investment-construction-phase.technical-systems.other-measures.safety-measures"
Sampling Costs                                                                                       = "semio.costs.global-life-cycle.life-cycle.investment-construction-phase.construction-ancillary.general.sampling-costs"
Scaffolding                                                                                          = "semio.costs.global-life-cycle.life-cycle.investment-construction-phase.building-structural-components.other-measures.scaffolding"
Scaffolding for Technical Systems                                                                    = "semio.costs.global-life-cycle.life-cycle.investment-construction-phase.technical-systems.other-measures.scaffolding"
Seals and Linings                                                                                    = "semio.costs.global-life-cycle.life-cycle.investment-construction-phase.building-structural-components.foundation-substructure.seals-and-linings"
Search and Signal Systems                                                                            = "semio.costs.global-life-cycle.life-cycle.investment-construction-phase.technical-systems.communication-safety-and-information-technology.search-and-signal"
Security and Maintenance Costs                                                                       = "semio.costs.global-life-cycle.life-cycle.operating-ongoing-use.security-and-maintenance"
Shallow Foundations and Slabs                                                                        = "semio.costs.global-life-cycle.life-cycle.investment-construction-phase.building-structural-components.foundation-substructure.shallow-foundations-and-slabs"
Site Preparation                                                                                     = "semio.costs.global-life-cycle.life-cycle.investment-construction-phase.development.preparatory-measures.site-preparation"
Soil Improvement                                                                                     = "semio.costs.global-life-cycle.life-cycle.investment-construction-phase.building-structural-components.foundation-substructure.soil-improvement"
Special Equipment                                                                                    = "semio.costs.global-life-cycle.life-cycle.investment-construction-phase.equipment-and-artworks.special-equipment"
Special Installations                                                                                = "semio.costs.global-life-cycle.life-cycle.investment-construction-phase.building-structural-components.structural-installations.special-installations"
Specialist Planning                                                                                  = "semio.costs.global-life-cycle.life-cycle.investment-construction-phase.construction-ancillary.specialist-planning"
Sports Field Areas                                                                                   = "semio.costs.global-life-cycle.life-cycle.investment-construction-phase.outdoor-facilities-and-open-spaces.pavement-surface-courses.sports-field-areas"
Squares Yards Terraces                                                                               = "semio.costs.global-life-cycle.life-cycle.investment-construction-phase.outdoor-facilities-and-open-spaces.pavement-surface-courses.squares-yards-terraces"
Structural Installations                                                                             = "semio.costs.global-life-cycle.life-cycle.investment-construction-phase.building-structural-components.structural-installations"
Structural Measures                                                                                  = "semio.costs.global-life-cycle.life-cycle.investment-construction-phase.development.preparatory-measures.transitional-measures.structural-measures"
Structural Planning                                                                                  = "semio.costs.global-life-cycle.life-cycle.investment-construction-phase.construction-ancillary.specialist-planning.structural-planning"
Surface Preparation                                                                                  = "semio.costs.global-life-cycle.life-cycle.investment-construction-phase.development.preparatory-measures.site-preparation.surface-preparation"
Surveying Fees                                                                                       = "semio.costs.global-life-cycle.life-cycle.investment-construction-phase.land.acquisition.ancillary.surveying-fees"
Taxes and Duties                                                                                     = "semio.costs.global-life-cycle.taxes-and-duties"
Technical Equipment Planning                                                                         = "semio.costs.global-life-cycle.life-cycle.investment-construction-phase.construction-ancillary.specialist-planning.technical-equipment"
Technical Systems                                                                                    = "semio.costs.global-life-cycle.life-cycle.investment-construction-phase.technical-systems"
Telecommunication Systems                                                                            = "semio.costs.global-life-cycle.life-cycle.investment-construction-phase.technical-systems.communication-safety-and-information-technology.telecommunication"
Telecommunications                                                                                   = "semio.costs.global-life-cycle.life-cycle.investment-construction-phase.development.preparatory-measures.public-infrastructure-development.telecommunications"
Temporary Structural Components                                                                      = "semio.costs.global-life-cycle.life-cycle.investment-construction-phase.building-structural-components.other-measures.temporary-structural-components"
Temporary Technical Systems                                                                          = "semio.costs.global-life-cycle.life-cycle.investment-construction-phase.technical-systems.other-measures.temporary-technical-systems"
Third Party Compensations                                                                            = "semio.costs.global-life-cycle.life-cycle.investment-construction-phase.land.acquisition.third-party-rights.compensations"
Third Party Redemption of Real Rights                                                                = "semio.costs.global-life-cycle.life-cycle.investment-construction-phase.land.acquisition.third-party-rights.redemption-of-real-rights"
Third Party Rights                                                                                   = "semio.costs.global-life-cycle.life-cycle.investment-construction-phase.land.acquisition.third-party-rights"
Time Service Systems                                                                                 = "semio.costs.global-life-cycle.life-cycle.investment-construction-phase.technical-systems.communication-safety-and-information-technology.time-service"
Track Systems                                                                                        = "semio.costs.global-life-cycle.life-cycle.investment-construction-phase.outdoor-facilities-and-open-spaces.pavement-surface-courses.track-systems"
Traffic Control Systems                                                                              = "semio.costs.global-life-cycle.life-cycle.investment-construction-phase.technical-systems.communication-safety-and-information-technology.traffic-control"
Traffic Development                                                                                  = "semio.costs.global-life-cycle.life-cycle.investment-construction-phase.development.preparatory-measures.public-infrastructure-development.traffic-development"
Traffic Facilities Planning                                                                          = "semio.costs.global-life-cycle.life-cycle.investment-construction-phase.construction-ancillary.object-planning.traffic-facilities"
Traffic Heating Surfaces                                                                             = "semio.costs.global-life-cycle.life-cycle.investment-construction-phase.technical-systems.heating-supply.traffic-heating-surfaces"
Transitional Measures                                                                                = "semio.costs.global-life-cycle.life-cycle.investment-construction-phase.development.preparatory-measures.transitional-measures"
Transport Systems                                                                                    = "semio.costs.global-life-cycle.life-cycle.investment-construction-phase.technical-systems.conveying.transport"
Urban Planning Services                                                                              = "semio.costs.global-life-cycle.life-cycle.investment-construction-phase.construction-ancillary.preparation-of-object-planning.urban-planning-services"
Usage Specific and Process Engineering Systems                                                       = "semio.costs.global-life-cycle.life-cycle.investment-construction-phase.technical-systems.usage-specific-and-process-engineering"
Valuations                                                                                           = "semio.costs.global-life-cycle.life-cycle.investment-construction-phase.construction-ancillary.preparation-of-object-planning.valuations"
Valuations                                                                                           = "semio.costs.global-life-cycle.life-cycle.investment-construction-phase.land.acquisition.ancillary.valuations"
Ventilation Systems                                                                                  = "semio.costs.global-life-cycle.life-cycle.investment-construction-phase.technical-systems.room-air-technology.ventilation"
Wall Structures                                                                                      = "semio.costs.global-life-cycle.life-cycle.investment-construction-phase.outdoor-facilities-and-open-spaces.structural-components.wall-structures"
Waste Disposal                                                                                       = "semio.costs.global-life-cycle.life-cycle.investment-construction-phase.development.preparatory-measures.public-infrastructure-development.waste-disposal"
Waste Disposal                                                                                       = "semio.costs.global-life-cycle.life-cycle.operating-ongoing-use.waste-disposal"
Waste Disposal Facilities                                                                            = "semio.costs.global-life-cycle.life-cycle.investment-construction-phase.building-structural-components.infrastructure-facilities.waste-disposal-facilities"
Wastewater Disposal                                                                                  = "semio.costs.global-life-cycle.life-cycle.investment-construction-phase.development.preparatory-measures.public-infrastructure-development.wastewater-disposal"
Wastewater Disposal Facilities                                                                       = "semio.costs.global-life-cycle.life-cycle.investment-construction-phase.building-structural-components.infrastructure-facilities.wastewater-disposal-facilities"
Wastewater Systems                                                                                   = "semio.costs.global-life-cycle.life-cycle.investment-construction-phase.technical-systems.wastewater-water-gas.wastewater"
Wastewater Water Gas Systems                                                                         = "semio.costs.global-life-cycle.life-cycle.investment-construction-phase.technical-systems.wastewater-water-gas"
Water Basins                                                                                         = "semio.costs.global-life-cycle.life-cycle.investment-construction-phase.outdoor-facilities-and-open-spaces.structural-components.water-basins"
Water Construction Facilities                                                                        = "semio.costs.global-life-cycle.life-cycle.investment-construction-phase.building-structural-components.infrastructure-facilities.water-construction-facilities"
Water Costs Wastewater Fees                                                                          = "semio.costs.global-life-cycle.life-cycle.operating-ongoing-use.water-wastewater-fees"
Water Supply                                                                                         = "semio.costs.global-life-cycle.life-cycle.investment-construction-phase.development.preparatory-measures.public-infrastructure-development.water-supply"
Water Supply Facilities                                                                              = "semio.costs.global-life-cycle.life-cycle.investment-construction-phase.building-structural-components.infrastructure-facilities.water-supply-facilities"
Water Systems                                                                                        = "semio.costs.global-life-cycle.life-cycle.investment-construction-phase.technical-systems.wastewater-water-gas.water"
Windows Replacement                                                                                  = "semio.costs.global-life-cycle.life-cycle.maintenance-and-modernization.replacement-of-components.windows"
