# PART 1: A-H (Alphabetical Division)
# Building lifecycle cost qualities from "Additional Construction Measures" through "Heating Supply Systems"
Additional Construction Measures                                                                     = "semio.costs.global-life-cycle.life-cycle.investment-construction-phase.building-structural-components.other-measures.additional-measures"
Additional Measures for Technical Systems                                                            = "semio.costs.global-life-cycle.life-cycle.investment-construction-phase.technical-systems.other-measures.additional-measures"
Air Conditioning Systems                                                                             = "semio.costs.global-life-cycle.life-cycle.investment-construction-phase.technical-systems.room-air-technology.air-conditioning"
Air Traffic Facilities                                                                               = "semio.costs.global-life-cycle.life-cycle.investment-construction-phase.building-structural-components.infrastructure-facilities.air-traffic-facilities"
Airfield Areas                                                                                       = "semio.costs.global-life-cycle.life-cycle.investment-construction-phase.outdoor-facilities-and-open-spaces.pavement-surface-courses.airfield-areas"
Ancillary Land Costs                                                                                 = "semio.costs.global-life-cycle.life-cycle.investment-construction-phase.land.acquisition.ancillary"
Art Competitions                                                                                     = "semio.costs.global-life-cycle.life-cycle.investment-construction-phase.construction-ancillary.artistic-services.art-competitions"
Art Objects                                                                                          = "semio.costs.global-life-cycle.life-cycle.investment-construction-phase.equipment-and-artworks.artistic-equipment.art-objects"
Artistic Design of Building                                                                          = "semio.costs.global-life-cycle.life-cycle.investment-construction-phase.equipment-and-artworks.artistic-equipment.artistic-design-of-the-building"
Artistic Design of Outdoor Facilities                                                                = "semio.costs.global-life-cycle.life-cycle.investment-construction-phase.equipment-and-artworks.artistic-equipment.artistic-design-of-outdoor-facilities-and-open-spaces"
Artistic Equipment                                                                                   = "semio.costs.global-life-cycle.life-cycle.investment-construction-phase.equipment-and-artworks.artistic-equipment"
Artistic Services                                                                                    = "semio.costs.global-life-cycle.life-cycle.investment-construction-phase.construction-ancillary.artistic-services"
Artistic Services Fees                                                                               = "semio.costs.global-life-cycle.life-cycle.investment-construction-phase.construction-ancillary.artistic-services.fees"
Audiovisual Media and Antenna Systems                                                                = "semio.costs.global-life-cycle.life-cycle.investment-construction-phase.technical-systems.communication-safety-and-information-technology.audiovisual-media-and-antenna"
Automation Devices                                                                                   = "semio.costs.global-life-cycle.life-cycle.investment-construction-phase.technical-systems.building-and-facility-automation.automation-devices"
Automation Management                                                                                = "semio.costs.global-life-cycle.life-cycle.investment-construction-phase.technical-systems.building-and-facility-automation.automation-management"
Award Procedures                                                                                     = "semio.costs.global-life-cycle.life-cycle.investment-construction-phase.construction-ancillary.client-tasks.award-procedures"
Barrier Free Conversion                                                                              = "semio.costs.global-life-cycle.life-cycle.maintenance-and-modernization.modernization.barrier-free-conversion"
Bridges                                                                                              = "semio.costs.global-life-cycle.life-cycle.investment-construction-phase.outdoor-facilities-and-open-spaces.structural-components.bridges"
Building and Facility Automation                                                                     = "semio.costs.global-life-cycle.life-cycle.investment-construction-phase.technical-systems.building-and-facility-automation"
Building Physics                                                                                     = "semio.costs.global-life-cycle.life-cycle.investment-construction-phase.construction-ancillary.specialist-planning.building-physics"
Building Structural Components                                                                       = "semio.costs.global-life-cycle.life-cycle.investment-construction-phase.building-structural-components"
Buildings and Interiors Planning                                                                     = "semio.costs.global-life-cycle.life-cycle.investment-construction-phase.construction-ancillary.object-planning.buildings-and-interiors"
Cables Lines and Laying Systems                                                                      = "semio.costs.global-life-cycle.life-cycle.investment-construction-phase.technical-systems.building-and-facility-automation.cables-lines-and-laying"
Canal and Shaft Structures                                                                           = "semio.costs.global-life-cycle.life-cycle.investment-construction-phase.outdoor-facilities-and-open-spaces.structural-components.canal-and-shaft-structures"
Caretaker                                                                                            = "semio.costs.global-life-cycle.life-cycle.operating-ongoing-use.operational-management.caretaker"
Catenary Systems                                                                                     = "semio.costs.global-life-cycle.life-cycle.investment-construction-phase.technical-systems.electrical.catenary"
Ceiling Claddings                                                                                    = "semio.costs.global-life-cycle.life-cycle.investment-construction-phase.building-structural-components.ceilings-horizontal-structural-components.ceiling-claddings"
Ceiling Openings                                                                                     = "semio.costs.global-life-cycle.life-cycle.investment-construction-phase.building-structural-components.ceilings-horizontal-structural-components.ceiling-openings"
Ceilings Horizontal Structural Components                                                            = "semio.costs.global-life-cycle.life-cycle.investment-construction-phase.building-structural-components.ceilings-horizontal-structural-components"
Civil Engineering Structures Planning                                                                = "semio.costs.global-life-cycle.life-cycle.investment-construction-phase.construction-ancillary.object-planning.civil-engineering-structures"
Client Tasks                                                                                         = "semio.costs.global-life-cycle.life-cycle.investment-construction-phase.construction-ancillary.client-tasks"
Communication, Safety and Information Technology Systems                                             = "semio.costs.global-life-cycle.life-cycle.investment-construction-phase.technical-systems.communication-safety-and-information-technology"
Compensatory Levies                                                                                  = "semio.costs.global-life-cycle.life-cycle.investment-construction-phase.development.preparatory-measures.compensatory-measures-and-levies.compensatory-levies"
Compensatory Measures                                                                                = "semio.costs.global-life-cycle.life-cycle.investment-construction-phase.development.preparatory-measures.compensatory-measures-and-levies.compensatory-measures"
Compensatory Measures and Levies                                                                     = "semio.costs.global-life-cycle.life-cycle.investment-construction-phase.development.preparatory-measures.compensatory-measures-and-levies"
Construction Ancillary Costs                                                                         = "semio.costs.global-life-cycle.life-cycle.investment-construction-phase.construction-ancillary"
Construction Demolition Measures                                                                     = "semio.costs.global-life-cycle.life-cycle.investment-construction-phase.building-structural-components.other-measures.demolition-measures"
Construction Insurance                                                                               = "semio.costs.global-life-cycle.life-cycle.investment-construction-phase.construction-ancillary.general.insurance"
Construction Material Disposal                                                                       = "semio.costs.global-life-cycle.life-cycle.investment-construction-phase.building-structural-components.other-measures.material-disposal"
Construction Operating Costs                                                                         = "semio.costs.global-life-cycle.life-cycle.investment-construction-phase.construction-ancillary.general.operating-costs"
Construction Renovations                                                                             = "semio.costs.global-life-cycle.life-cycle.investment-construction-phase.building-structural-components.other-measures.renovations"
Construction Safety Measures                                                                         = "semio.costs.global-life-cycle.life-cycle.investment-construction-phase.building-structural-components.other-measures.safety-measures"
Construction Site Facilities                                                                         = "semio.costs.global-life-cycle.life-cycle.investment-construction-phase.building-structural-components.other-measures.construction-site-facilities"
Construction Site Facilities for Technical Systems                                                   = "semio.costs.global-life-cycle.life-cycle.investment-construction-phase.technical-systems.other-measures.construction-site-facilities"
Contaminated Site Remediation                                                                        = "semio.costs.global-life-cycle.life-cycle.investment-construction-phase.development.preparatory-measures.site-preparation.contaminated-site-remediation"
Contaminated Sites Explosive Ordnance Cultural Heritage Finds                                        = "semio.costs.global-life-cycle.life-cycle.investment-construction-phase.construction-ancillary.specialist-planning.contaminated-sites-explosive-ordnance-cultural-heritage-finds"
Control Cabinets Automation Hubs                                                                     = "semio.costs.global-life-cycle.life-cycle.investment-construction-phase.technical-systems.building-and-facility-automation.control-cabinets-automation-hubs"
Conveying Systems                                                                                    = "semio.costs.global-life-cycle.life-cycle.investment-construction-phase.technical-systems.conveying"
Conveyor Systems                                                                                     = "semio.costs.global-life-cycle.life-cycle.investment-construction-phase.technical-systems.conveying.conveyor"
Costs for Common Facilities                                                                          = "semio.costs.global-life-cycle.life-cycle.operating-ongoing-use.common-facilities"
Court Fees                                                                                           = "semio.costs.global-life-cycle.life-cycle.investment-construction-phase.land.acquisition.ancillary.court-fees"
Crane Systems                                                                                        = "semio.costs.global-life-cycle.life-cycle.investment-construction-phase.technical-systems.conveying.crane"
Cultural Heritage Finds                                                                              = "semio.costs.global-life-cycle.life-cycle.investment-construction-phase.development.preparatory-measures.site-preparation.cultural-heritage-finds"
Data Transmission Networks                                                                           = "semio.costs.global-life-cycle.life-cycle.investment-construction-phase.technical-systems.building-and-facility-automation.data-transmission-networks"
Data Transmission Networks                                                                           = "semio.costs.global-life-cycle.life-cycle.investment-construction-phase.technical-systems.communication-safety-and-information-technology.data-transmission-networks"
Deep Foundations                                                                                     = "semio.costs.global-life-cycle.life-cycle.investment-construction-phase.building-structural-components.foundation-substructure.deep-foundations"
Demolition Costs                                                                                     = "semio.costs.global-life-cycle.life-cycle.dismantling-and-disposal.demolition"
Demolition Measures                                                                                  = "semio.costs.global-life-cycle.life-cycle.investment-construction-phase.development.preparatory-measures.site-preparation.demolition-measures"
Demolition Measures for Technical Systems                                                            = "semio.costs.global-life-cycle.life-cycle.investment-construction-phase.technical-systems.other-measures.demolition-measures"
Development Costs                                                                                    = "semio.costs.global-life-cycle.life-cycle.investment-construction-phase.development"
Dismantling and Disposal Costs                                                                       = "semio.costs.global-life-cycle.life-cycle.dismantling-and-disposal"
Disposal of Contaminated Materials                                                                   = "semio.costs.global-life-cycle.life-cycle.dismantling-and-disposal.disposal-of-contaminated-materials"
District Heating Supply                                                                              = "semio.costs.global-life-cycle.life-cycle.investment-construction-phase.development.preparatory-measures.public-infrastructure-development.district-heating-supply"
Documentation of Existing Conditions                                                                 = "semio.costs.global-life-cycle.life-cycle.investment-construction-phase.construction-ancillary.other.documentation-of-existing-conditions"
Drains                                                                                               = "semio.costs.global-life-cycle.life-cycle.investment-construction-phase.building-structural-components.foundation-substructure.drains"
Electrical Systems                                                                                   = "semio.costs.global-life-cycle.life-cycle.investment-construction-phase.technical-systems.electrical"
Electricity                                                                                          = "semio.costs.global-life-cycle.life-cycle.operating-ongoing-use.energy.electricity"
Electroacoustic Systems                                                                              = "semio.costs.global-life-cycle.life-cycle.investment-construction-phase.technical-systems.communication-safety-and-information-technology.electroacoustic"
Elevator Systems                                                                                     = "semio.costs.global-life-cycle.life-cycle.investment-construction-phase.technical-systems.conveying.elevator"
Elevators Maintenance                                                                                = "semio.costs.global-life-cycle.life-cycle.maintenance-and-modernization.regular-maintenance.elevators"
Elevators Operating Costs                                                                            = "semio.costs.global-life-cycle.life-cycle.operating-ongoing-use.common-facilities.elevators"
Emergency Power Supply Systems                                                                       = "semio.costs.global-life-cycle.life-cycle.investment-construction-phase.technical-systems.electrical.emergency-power-supply"
Energy and Information Supply Facilities                                                             = "semio.costs.global-life-cycle.life-cycle.investment-construction-phase.building-structural-components.infrastructure-facilities.energy-and-information-supply-facilities"
Energy Costs                                                                                         = "semio.costs.global-life-cycle.life-cycle.operating-ongoing-use.energy"
Energy Rehabilitation                                                                                = "semio.costs.global-life-cycle.life-cycle.maintenance-and-modernization.modernization.energy-rehabilitation"
Engineering Surveying                                                                                = "semio.costs.global-life-cycle.life-cycle.investment-construction-phase.construction-ancillary.specialist-planning.engineering-surveying"
Equipment and Artworks                                                                               = "semio.costs.global-life-cycle.life-cycle.investment-construction-phase.equipment-and-artworks"
Escalators and Moving Walkways                                                                       = "semio.costs.global-life-cycle.life-cycle.investment-construction-phase.technical-systems.conveying.escalators-and-moving-walkways"
Excavation Construction                                                                              = "semio.costs.global-life-cycle.life-cycle.investment-construction-phase.building-structural-components.excavation-earthworks.construction"
Excavation Conveyance                                                                                = "semio.costs.global-life-cycle.life-cycle.investment-construction-phase.building-structural-components.excavation-earthworks.conveyance"
Excavation Earthworks                                                                                = "semio.costs.global-life-cycle.life-cycle.investment-construction-phase.building-structural-components.excavation-earthworks"
Excavation Enclosure                                                                                 = "semio.costs.global-life-cycle.life-cycle.investment-construction-phase.building-structural-components.excavation-earthworks.enclosure"
Excavation Water Management                                                                          = "semio.costs.global-life-cycle.life-cycle.investment-construction-phase.building-structural-components.excavation-earthworks.water-management"
Expertise and Consulting                                                                             = "semio.costs.global-life-cycle.life-cycle.investment-construction-phase.construction-ancillary.general.expertise-and-consulting"
Explosive Ordnance Clearance                                                                         = "semio.costs.global-life-cycle.life-cycle.investment-construction-phase.development.preparatory-measures.site-preparation.explosive-ordnance-clearance"
External Columns                                                                                     = "semio.costs.global-life-cycle.life-cycle.investment-construction-phase.building-structural-components.external-walls-vertical-structural-components-outside.external-columns"
External Wall Claddings Inside                                                                       = "semio.costs.global-life-cycle.life-cycle.investment-construction-phase.building-structural-components.external-walls-vertical-structural-components-outside.external-wall-claddings-inside"
External Wall Claddings Outside                                                                      = "semio.costs.global-life-cycle.life-cycle.investment-construction-phase.building-structural-components.external-walls-vertical-structural-components-outside.external-wall-claddings-outside"
External Wall Openings                                                                               = "semio.costs.global-life-cycle.life-cycle.investment-construction-phase.building-structural-components.external-walls-vertical-structural-components-outside.external-wall-openings"
External Walls Vertical Structural Components Outside                                                = "semio.costs.global-life-cycle.life-cycle.investment-construction-phase.building-structural-components.external-walls-vertical-structural-components-outside"
Facade Replacement                                                                                   = "semio.costs.global-life-cycle.life-cycle.maintenance-and-modernization.replacement-of-components.facade"
Fences                                                                                               = "semio.costs.global-life-cycle.life-cycle.investment-construction-phase.outdoor-facilities-and-open-spaces.structural-components.fences"
Financing Costs                                                                                      = "semio.costs.global-life-cycle.financing"
Financing Fees                                                                                       = "semio.costs.global-life-cycle.financing.fees"
Fire Alarm and Alert Systems                                                                         = "semio.costs.global-life-cycle.life-cycle.investment-construction-phase.technical-systems.communication-safety-and-information-technology.fire-alarm-and-alert"
Fire Extinguishing Systems                                                                           = "semio.costs.global-life-cycle.life-cycle.investment-construction-phase.technical-systems.usage-specific-and-process-engineering.fire-extinguishing"
Fire Protection Planning                                                                             = "semio.costs.global-life-cycle.life-cycle.investment-construction-phase.construction-ancillary.specialist-planning.fire-protection"
Foundation Layers                                                                                    = "semio.costs.global-life-cycle.life-cycle.investment-construction-phase.building-structural-components.foundation-substructure.foundation-layers"
Foundation Substructure                                                                              = "semio.costs.global-life-cycle.life-cycle.investment-construction-phase.building-structural-components.foundation-substructure"
Gas Supply                                                                                           = "semio.costs.global-life-cycle.life-cycle.investment-construction-phase.development.preparatory-measures.public-infrastructure-development.gas-supply"
Gas Systems                                                                                          = "semio.costs.global-life-cycle.life-cycle.investment-construction-phase.technical-systems.wastewater-water-gas.gas"
General Construction Ancillary Costs                                                                 = "semio.costs.global-life-cycle.life-cycle.investment-construction-phase.construction-ancillary.general"
General Equipment                                                                                    = "semio.costs.global-life-cycle.life-cycle.investment-construction-phase.equipment-and-artworks.general-equipment"
General Installations                                                                                = "semio.costs.global-life-cycle.life-cycle.investment-construction-phase.building-structural-components.structural-installations.general-installations"
Geotechnics                                                                                          = "semio.costs.global-life-cycle.life-cycle.investment-construction-phase.construction-ancillary.specialist-planning.geotechnics"
Global Life-Cycle Costs                                                                              = "semio.costs.global-life-cycle"
Grants and Subsidies                                                                                 = "semio.costs.global-life-cycle.grants-subsidies"
Heat Distribution Networks                                                                           = "semio.costs.global-life-cycle.life-cycle.investment-construction-phase.technical-systems.heating-supply.heat-distribution-networks"
Heat Generation Systems                                                                              = "semio.costs.global-life-cycle.life-cycle.investment-construction-phase.technical-systems.heating-supply.heat-generation"
Heating                                                                                              = "semio.costs.global-life-cycle.life-cycle.operating-ongoing-use.energy.heating"
Heating Supply Systems                                                                               = "semio.costs.global-life-cycle.life-cycle.investment-construction-phase.technical-systems.heating-supply"
