# PART 2: H-O (Alphabetical Division)
# Building lifecycle cost qualities from "Heating Systems Maintenance" through "Outdoor Foundation Substructure"
Heating Systems Maintenance                                                                          = "semio.costs.global-life-cycle.life-cycle.maintenance-and-modernization.regular-maintenance.heating-systems"
High and Medium Voltage Systems                                                                      = "semio.costs.global-life-cycle.life-cycle.investment-construction-phase.technical-systems.electrical.high-and-medium-voltage"
Hot Water                                                                                            = "semio.costs.global-life-cycle.life-cycle.operating-ongoing-use.energy.hot-water"
Hydraulic Systems                                                                                    = "semio.costs.global-life-cycle.life-cycle.investment-construction-phase.technical-systems.conveying.hydraulic"
Income                                                                                               = "semio.costs.global-life-cycle.income"
Information Technology Equipment                                                                     = "semio.costs.global-life-cycle.life-cycle.investment-construction-phase.equipment-and-artworks.information-technology-equipment"
Infrastructure Facilities                                                                            = "semio.costs.global-life-cycle.life-cycle.investment-construction-phase.building-structural-components.infrastructure-facilities"
Inspections Approvals Acceptance                                                                     = "semio.costs.global-life-cycle.life-cycle.investment-construction-phase.construction-ancillary.general.inspections-approvals-acceptance"
Installations in Civil Engineering Structures                                                        = "semio.costs.global-life-cycle.life-cycle.investment-construction-phase.building-structural-components.structural-installations.installations-in-civil-engineering-structures"
Insurance                                                                                            = "semio.costs.global-life-cycle.life-cycle.operating-ongoing-use.operational-management.insurance"
Interest                                                                                             = "semio.costs.global-life-cycle.financing.interest"
Internal Columns                                                                                     = "semio.costs.global-life-cycle.life-cycle.investment-construction-phase.building-structural-components.internal-walls-vertical-structural-components-inside.internal-columns"
Internal Wall Claddings                                                                              = "semio.costs.global-life-cycle.life-cycle.investment-construction-phase.building-structural-components.internal-walls-vertical-structural-components-inside.internal-wall-claddings"
Internal Wall Openings                                                                               = "semio.costs.global-life-cycle.life-cycle.investment-construction-phase.building-structural-components.internal-walls-vertical-structural-components-inside.internal-wall-openings"
Internal Walls Vertical Structural Components Inside                                                 = "semio.costs.global-life-cycle.life-cycle.investment-construction-phase.building-structural-components.internal-walls-vertical-structural-components-inside"
Investigations                                                                                       = "semio.costs.global-life-cycle.life-cycle.investment-construction-phase.construction-ancillary.preparation-of-object-planning.investigations"
Investigations                                                                                       = "semio.costs.global-life-cycle.life-cycle.investment-construction-phase.land.acquisition.ancillary.investigations"
Investment Costs Construction Phase                                                                  = "semio.costs.global-life-cycle.life-cycle.investment-construction-phase"
Kitchen Technology Systems                                                                           = "semio.costs.global-life-cycle.life-cycle.investment-construction-phase.technical-systems.usage-specific-and-process-engineering.kitchen-technology"
Land Acquisition                                                                                     = "semio.costs.global-life-cycle.life-cycle.investment-construction-phase.land.acquisition"
Land Compensations                                                                                   = "semio.costs.global-life-cycle.life-cycle.investment-construction-phase.land.acquisition.compensations"
Land Costs                                                                                           = "semio.costs.global-life-cycle.life-cycle.investment-construction-phase.land"
Land Redemption of Real Rights                                                                       = "semio.costs.global-life-cycle.life-cycle.investment-construction-phase.land.acquisition.redemption-of-real-rights"
Land Reorganization                                                                                  = "semio.costs.global-life-cycle.life-cycle.investment-construction-phase.land.acquisition.ancillary.reorganization"
Land Transfer Tax                                                                                    = "semio.costs.global-life-cycle.life-cycle.investment-construction-phase.land.acquisition.ancillary.transfer-tax"
Land Value                                                                                           = "semio.costs.global-life-cycle.life-cycle.investment-construction-phase.land.acquisition.value"
Landscape Architectural Installations                                                                = "semio.costs.global-life-cycle.life-cycle.investment-construction-phase.building-structural-components.structural-installations.landscape-architectural-installations"
Landscape Planning Services                                                                          = "semio.costs.global-life-cycle.life-cycle.investment-construction-phase.construction-ancillary.preparation-of-object-planning.landscape-planning-services"
Laundry Cleaning and Bathing Technology Systems                                                      = "semio.costs.global-life-cycle.life-cycle.investment-construction-phase.technical-systems.usage-specific-and-process-engineering.laundry-cleaning-and-bathing-technology"
Life-Cycle Costs                                                                                     = "semio.costs.global-life-cycle.life-cycle"
Light Protection KG 330                                                                              = "semio.costs.global-life-cycle.life-cycle.investment-construction-phase.building-structural-components.external-walls-vertical-structural-components-outside.light-protection-kg-330"
Light Protection KG 360                                                                              = "semio.costs.global-life-cycle.life-cycle.investment-construction-phase.building-structural-components.roofs.light-protection-kg-360"
Lighting Systems                                                                                     = "semio.costs.global-life-cycle.life-cycle.investment-construction-phase.technical-systems.electrical.lighting"
Lighting Technology Daylight Technology                                                              = "semio.costs.global-life-cycle.life-cycle.investment-construction-phase.construction-ancillary.specialist-planning.lighting-technology-daylight-technology"
Lightning Protection and Grounding Systems                                                           = "semio.costs.global-life-cycle.life-cycle.investment-construction-phase.technical-systems.electrical.lightning-protection-and-grounding"
Load Bearing Ceilings                                                                                = "semio.costs.global-life-cycle.life-cycle.investment-construction-phase.building-structural-components.ceilings-horizontal-structural-components.load-bearing-ceilings"
Load Bearing External Walls                                                                          = "semio.costs.global-life-cycle.life-cycle.investment-construction-phase.building-structural-components.external-walls-vertical-structural-components-outside.load-bearing-external-walls"
Load Bearing Internal Walls                                                                          = "semio.costs.global-life-cycle.life-cycle.investment-construction-phase.building-structural-components.internal-walls-vertical-structural-components-inside.load-bearing-internal-walls"
Low Voltage Installation Systems                                                                     = "semio.costs.global-life-cycle.life-cycle.investment-construction-phase.technical-systems.electrical.low-voltage-installation"
Low Voltage Switchgear                                                                               = "semio.costs.global-life-cycle.life-cycle.investment-construction-phase.technical-systems.electrical.low-voltage-switchgear"
Maintenance and Modernization Costs                                                                  = "semio.costs.global-life-cycle.life-cycle.maintenance-and-modernization"
Material Disposal for Technical Systems                                                              = "semio.costs.global-life-cycle.life-cycle.investment-construction-phase.technical-systems.other-measures.material-disposal"
Mechanical Installations                                                                             = "semio.costs.global-life-cycle.life-cycle.investment-construction-phase.building-structural-components.structural-installations.mechanical-installations"
Media Supply Medical and Laboratory Technology Systems                                               = "semio.costs.global-life-cycle.life-cycle.investment-construction-phase.technical-systems.usage-specific-and-process-engineering.media-supply-medical-and-laboratory-technology"
Modernization                                                                                        = "semio.costs.global-life-cycle.life-cycle.maintenance-and-modernization.modernization"
Needs Assessment                                                                                     = "semio.costs.global-life-cycle.life-cycle.investment-construction-phase.construction-ancillary.client-tasks.needs-assessment"
Non Load Bearing Ceilings                                                                            = "semio.costs.global-life-cycle.life-cycle.investment-construction-phase.building-structural-components.ceilings-horizontal-structural-components.non-load-bearing-ceilings"
Non Load Bearing External Walls                                                                      = "semio.costs.global-life-cycle.life-cycle.investment-construction-phase.building-structural-components.external-walls-vertical-structural-components-outside.non-load-bearing-external-walls"
Non Load Bearing Internal Walls                                                                      = "semio.costs.global-life-cycle.life-cycle.investment-construction-phase.building-structural-components.internal-walls-vertical-structural-components-inside.non-load-bearing-internal-walls"
Notary Fees                                                                                          = "semio.costs.global-life-cycle.life-cycle.investment-construction-phase.land.acquisition.ancillary.notary-fees"
Object Planning                                                                                      = "semio.costs.global-life-cycle.life-cycle.investment-construction-phase.construction-ancillary.object-planning"
Open Spaces Planning                                                                                 = "semio.costs.global-life-cycle.life-cycle.investment-construction-phase.construction-ancillary.object-planning.open-spaces"
Operating Costs After Acceptance                                                                     = "semio.costs.global-life-cycle.life-cycle.investment-construction-phase.construction-ancillary.general.operating-costs-after-acceptance"
Operating Costs Ongoing Use                                                                          = "semio.costs.global-life-cycle.life-cycle.operating-ongoing-use"
Operational Management Costs                                                                         = "semio.costs.global-life-cycle.life-cycle.operating-ongoing-use.operational-management"
Organizational Measures                                                                              = "semio.costs.global-life-cycle.life-cycle.investment-construction-phase.development.preparatory-measures.transitional-measures.organizational-measures"
Orientation and Information Systems                                                                  = "semio.costs.global-life-cycle.life-cycle.investment-construction-phase.building-structural-components.structural-installations.orientation-and-information-systems"
Other Ancillary Land Costs                                                                           = "semio.costs.global-life-cycle.life-cycle.investment-construction-phase.land.acquisition.ancillary.other"
Other Artistic Equipment                                                                             = "semio.costs.global-life-cycle.life-cycle.investment-construction-phase.equipment-and-artworks.artistic-equipment.other"
Other Artistic Services                                                                              = "semio.costs.global-life-cycle.life-cycle.investment-construction-phase.construction-ancillary.artistic-services.other"
Other Building and Facility Automation                                                               = "semio.costs.global-life-cycle.life-cycle.investment-construction-phase.technical-systems.building-and-facility-automation.other"
Other Ceiling Costs                                                                                  = "semio.costs.global-life-cycle.life-cycle.investment-construction-phase.building-structural-components.ceilings-horizontal-structural-components.other"
Other Client Tasks                                                                                   = "semio.costs.global-life-cycle.life-cycle.investment-construction-phase.construction-ancillary.client-tasks.other"
Other Communication Safety and IT Systems                                                            = "semio.costs.global-life-cycle.life-cycle.investment-construction-phase.technical-systems.communication-safety-and-information-technology.other"
Other Compensatory Costs                                                                             = "semio.costs.global-life-cycle.life-cycle.investment-construction-phase.development.preparatory-measures.compensatory-measures-and-levies.other"
Other Construction Ancillary Costs                                                                   = "semio.costs.global-life-cycle.life-cycle.investment-construction-phase.construction-ancillary.other"
Other Construction Measures                                                                          = "semio.costs.global-life-cycle.life-cycle.investment-construction-phase.building-structural-components.other-measures.other"
Other Conveying Systems                                                                              = "semio.costs.global-life-cycle.life-cycle.investment-construction-phase.technical-systems.conveying.other"
Other Development Costs                                                                              = "semio.costs.global-life-cycle.life-cycle.investment-construction-phase.development.other"
Other Electrical Systems                                                                             = "semio.costs.global-life-cycle.life-cycle.investment-construction-phase.technical-systems.electrical.other"
Other Equipment                                                                                      = "semio.costs.global-life-cycle.life-cycle.investment-construction-phase.equipment-and-artworks.other"
Other Excavation Costs                                                                               = "semio.costs.global-life-cycle.life-cycle.investment-construction-phase.building-structural-components.excavation-earthworks.other"
Other External Wall Costs                                                                            = "semio.costs.global-life-cycle.life-cycle.investment-construction-phase.building-structural-components.external-walls-vertical-structural-components-outside.other"
Other Foundation Costs                                                                               = "semio.costs.global-life-cycle.life-cycle.investment-construction-phase.building-structural-components.foundation-substructure.other"
Other General Construction Ancillary                                                                 = "semio.costs.global-life-cycle.life-cycle.investment-construction-phase.construction-ancillary.general.other"
Other Heating Supply Systems                                                                         = "semio.costs.global-life-cycle.life-cycle.investment-construction-phase.technical-systems.heating-supply.other"
Other Infrastructure Facilities                                                                      = "semio.costs.global-life-cycle.life-cycle.investment-construction-phase.building-structural-components.infrastructure-facilities.other"
Other Internal Wall Costs                                                                            = "semio.costs.global-life-cycle.life-cycle.investment-construction-phase.building-structural-components.internal-walls-vertical-structural-components-inside.other"
Other Land Acquisition Costs                                                                         = "semio.costs.global-life-cycle.life-cycle.investment-construction-phase.land.acquisition.other"
Other Land Related Costs                                                                             = "semio.costs.global-life-cycle.life-cycle.investment-construction-phase.land.other"
Other Measures for Structural Components                                                             = "semio.costs.global-life-cycle.life-cycle.investment-construction-phase.building-structural-components.other-measures"
Other Measures for Technical Systems                                                                 = "semio.costs.global-life-cycle.life-cycle.investment-construction-phase.technical-systems.other-measures"
Other Miscellaneous Ancillary Costs                                                                  = "semio.costs.global-life-cycle.life-cycle.investment-construction-phase.construction-ancillary.other.other"
Other Object Planning                                                                                = "semio.costs.global-life-cycle.life-cycle.investment-construction-phase.construction-ancillary.object-planning.other"
Other Outdoor Earthworks                                                                             = "semio.costs.global-life-cycle.life-cycle.investment-construction-phase.outdoor-facilities-and-open-spaces.earthworks.other"
Other Outdoor Foundation Costs                                                                       = "semio.costs.global-life-cycle.life-cycle.investment-construction-phase.outdoor-facilities-and-open-spaces.foundation-substructure.other"
Other Outdoor Structural Components                                                                  = "semio.costs.global-life-cycle.life-cycle.investment-construction-phase.outdoor-facilities-and-open-spaces.structural-components.other"
Other Outdoor Technical Systems                                                                      = "semio.costs.global-life-cycle.life-cycle.investment-construction-phase.outdoor-facilities-and-open-spaces.technical-systems.other"
Other Pavement Areas                                                                                 = "semio.costs.global-life-cycle.life-cycle.investment-construction-phase.outdoor-facilities-and-open-spaces.pavement-surface-courses.other"
Other Planning Preparation                                                                           = "semio.costs.global-life-cycle.life-cycle.investment-construction-phase.construction-ancillary.preparation-of-object-planning.other"
Other Public Infrastructure                                                                          = "semio.costs.global-life-cycle.life-cycle.investment-construction-phase.development.preparatory-measures.public-infrastructure-development.other"
Other Roof Costs                                                                                     = "semio.costs.global-life-cycle.life-cycle.investment-construction-phase.building-structural-components.roofs.other"
Other Room Air Technology Systems                                                                    = "semio.costs.global-life-cycle.life-cycle.investment-construction-phase.technical-systems.room-air-technology.other"
Other Site Preparation                                                                               = "semio.costs.global-life-cycle.life-cycle.investment-construction-phase.development.preparatory-measures.site-preparation.other"
Other Specialist Planning                                                                            = "semio.costs.global-life-cycle.life-cycle.investment-construction-phase.construction-ancillary.specialist-planning.other"
Other Structural Installations                                                                       = "semio.costs.global-life-cycle.life-cycle.investment-construction-phase.building-structural-components.structural-installations.other"
Other Technical Systems Measures                                                                     = "semio.costs.global-life-cycle.life-cycle.investment-construction-phase.technical-systems.other-measures.other"
Other Third Party Rights                                                                             = "semio.costs.global-life-cycle.life-cycle.investment-construction-phase.land.acquisition.third-party-rights.other"
Other Transitional Measures                                                                          = "semio.costs.global-life-cycle.life-cycle.investment-construction-phase.development.preparatory-measures.transitional-measures.other"
Other Usage Specific and Process Engineering Systems                                                 = "semio.costs.global-life-cycle.life-cycle.investment-construction-phase.technical-systems.usage-specific-and-process-engineering.other"
Other Utility Systems                                                                                = "semio.costs.global-life-cycle.life-cycle.investment-construction-phase.technical-systems.wastewater-water-gas.other"
Outdoor Communication Safety and Information Technology Automation                                   = "semio.costs.global-life-cycle.life-cycle.investment-construction-phase.outdoor-facilities-and-open-spaces.technical-systems.communication-safety-and-information-technology-automation"
Outdoor Drains                                                                                       = "semio.costs.global-life-cycle.life-cycle.investment-construction-phase.outdoor-facilities-and-open-spaces.foundation-substructure.drains"
Outdoor Earthworks                                                                                   = "semio.costs.global-life-cycle.life-cycle.investment-construction-phase.outdoor-facilities-and-open-spaces.earthworks"
Outdoor Earthworks Construction                                                                      = "semio.costs.global-life-cycle.life-cycle.investment-construction-phase.outdoor-facilities-and-open-spaces.earthworks.construction"
Outdoor Earthworks Conveyance                                                                        = "semio.costs.global-life-cycle.life-cycle.investment-construction-phase.outdoor-facilities-and-open-spaces.earthworks.conveyance"
Outdoor Earthworks Enclosure                                                                         = "semio.costs.global-life-cycle.life-cycle.investment-construction-phase.outdoor-facilities-and-open-spaces.earthworks.enclosure"
Outdoor Earthworks Water Management                                                                  = "semio.costs.global-life-cycle.life-cycle.investment-construction-phase.outdoor-facilities-and-open-spaces.earthworks.water-management"
Outdoor Electrical Systems                                                                           = "semio.costs.global-life-cycle.life-cycle.investment-construction-phase.outdoor-facilities-and-open-spaces.technical-systems.electrical"
Outdoor Facilities and Open Spaces                                                                   = "semio.costs.global-life-cycle.life-cycle.investment-construction-phase.outdoor-facilities-and-open-spaces"
Outdoor Foundation Layers                                                                            = "semio.costs.global-life-cycle.life-cycle.investment-construction-phase.outdoor-facilities-and-open-spaces.foundation-substructure.foundation-layers"
Outdoor Foundation Substructure                                                                      = "semio.costs.global-life-cycle.life-cycle.investment-construction-phase.outdoor-facilities-and-open-spaces.foundation-substructure"
